"filename", "language", "C#", "comment", "blank", "total"
"c:\Users\danie\Desktop\symfonia-mistrzow-game\Assets\Scripts\Commands\Command.cs", "C#", 28, 0, 6, 34
"c:\Users\danie\Desktop\symfonia-mistrzow-game\Assets\Scripts\Commands\CommandFactory.cs", "C#", 12, 0, 3, 15
"c:\Users\danie\Desktop\symfonia-mistrzow-game\Assets\Scripts\Commands\GameUICommand.cs", "C#", 43, 0, 11, 54
"c:\Users\danie\Desktop\symfonia-mistrzow-game\Assets\Scripts\Data\MusicCardData.cs", "C#", -11, -2, 0, -13
"c:\Users\danie\Desktop\symfonia-mistrzow-game\Assets\Scripts\Events\UIEvents.cs", "C#", 25, 1, 5, 31
"c:\Users\danie\Desktop\symfonia-mistrzow-game\Assets\Scripts\Models\BoardModel.cs", "C#", 37, 0, 7, 44
"c:\Users\danie\Desktop\symfonia-mistrzow-game\Assets\Scripts\Models\GameModel.cs", "C#", -228, -13, -56, -297
"c:\Users\danie\Desktop\symfonia-mistrzow-game\Assets\Scripts\Services\BoardService.cs", "C#", 8, 0, 2, 10
"c:\Users\danie\Desktop\symfonia-mistrzow-game\Assets\Scripts\Services\TurnService.cs", "C#", 9, 0, 3, 12
"c:\Users\danie\Desktop\symfonia-mistrzow-game\Assets\Scripts\UI\Board\BoardCardDeck\BoardCardDeckPresenter.cs", "C#", 11, 0, -2, 9
"c:\Users\danie\Desktop\symfonia-mistrzow-game\Assets\Scripts\UI\Board\BoardCardDeck\BoardCardDeckView.cs", "C#", 8, 0, 1, 9
"c:\Users\danie\Desktop\symfonia-mistrzow-game\Assets\Scripts\UI\GameWindow\GameWindowPresenter.cs", "C#", -2, 0, 0, -2
"c:\Users\danie\Desktop\symfonia-mistrzow-game\Assets\Scripts\UI\GameWindow\GameWindowView.cs", "C#", 3, 0, 0, 3
"c:\Users\danie\Desktop\symfonia-mistrzow-game\Assets\Scripts\UI\MusicCardDetailsPanel\DetailsMusicCardView.cs", "C#", 11, 0, 2, 13
"c:\Users\danie\Desktop\symfonia-mistrzow-game\Assets\Scripts\UI\PlayerResourcesWindow\PlayerResourcesWindowPresenter.cs", "C#", 13, 0, 1, 14
"c:\Users\danie\Desktop\symfonia-mistrzow-game\Assets\Scripts\UI\PlayerResourcesWindow\PlayerResourcesWindowView.cs", "C#", 9, 0, 0, 9
"c:\Users\danie\Desktop\symfonia-mistrzow-game\Assets\Scripts\UI\PlayerResourcesWindow\PlayerResourcesWindowViewModel.cs", "C#", 11, 0, 0, 11
"c:\Users\danie\Desktop\symfonia-mistrzow-game\Assets\Scripts\UI\ReserveDeckCardWindow\ReserveDeckCardOpenWindowAnimation.cs", "C#", 24, 0, 5, 29
"c:\Users\danie\Desktop\symfonia-mistrzow-game\Assets\Scripts\UI\ReserveDeckCardWindow\ReserveDeckCardWindowPresenter.cs", "C#", 72, 0, 15, 87
"c:\Users\danie\Desktop\symfonia-mistrzow-game\Assets\Scripts\UI\ReserveDeckCardWindow\ReserveDeckCardWindowView.cs", "C#", 57, 0, 13, 70
"c:\Users\danie\Desktop\symfonia-mistrzow-game\Assets\Scripts\UI\ReserveDeckCardWindow\ReserveDeckCardWindowViewModel.cs", "C#", 11, 0, 1, 12
"c:\Users\danie\Desktop\symfonia-mistrzow-game\Assets\Scripts\UI\SelectTokenWindow\SelectBoardTokenPanel\SelectBoardTokenPanelPresenter.cs", "C#", -1, 0, 0, -1
"Total", "-", 150, -14, 17, 153