"filename", "language", "C#", "comment", "blank", "total"
"c:\Users\danie\Desktop\symfonia-mistrzow-game\Assets\Scripts\Commands\Command.cs", "C#", 33, 0, 9, 42
"c:\Users\danie\Desktop\symfonia-mistrzow-game\Assets\Scripts\Commands\CommandFactory.cs", "C#", 4, 0, 1, 5
"c:\Users\danie\Desktop\symfonia-mistrzow-game\Assets\Scripts\Events\GameEvents.cs", "C#", 3, 0, 0, 3
"c:\Users\danie\Desktop\symfonia-mistrzow-game\Assets\Scripts\Events\UIEvents.cs", "C#", 12, 0, 3, 15
"c:\Users\danie\Desktop\symfonia-mistrzow-game\Assets\Scripts\Services\TurnService.cs", "C#", 8, 0, 2, 10
"c:\Users\danie\Desktop\symfonia-mistrzow-game\Assets\Scripts\UI\Board\BoardPlayerPanel\BoardPlayersPanelPresenter.cs", "C#", 51, 0, 13, 64
"c:\Users\danie\Desktop\symfonia-mistrzow-game\Assets\Scripts\UI\Board\BoardPlayerPanel\BoardPlayersPanelView.cs", "C#", 29, 0, 7, 36
"c:\Users\danie\Desktop\symfonia-mistrzow-game\Assets\Scripts\UI\Board\BoardPlayerPanel\BoardPlayersPanelViewModel.cs", "C#", 33, 0, 5, 38
"c:\Users\danie\Desktop\symfonia-mistrzow-game\Assets\Scripts\UI\Board\BoardPlayersPanel\BoardPlayersPanelPresenter.cs", "C#", -71, 0, -16, -87
"c:\Users\danie\Desktop\symfonia-mistrzow-game\Assets\Scripts\UI\Board\BoardPlayersPanel\BoardPlayersPanelView.cs", "C#", -10, 0, -2, -12
"c:\Users\danie\Desktop\symfonia-mistrzow-game\Assets\Scripts\UI\Board\BoardPlayersPanel\BoardPlayersPanelViewModel.cs", "C#", -6, 0, -1, -7
"c:\Users\danie\Desktop\symfonia-mistrzow-game\Assets\Scripts\UI\Board\BoardPlayersPanel\BoardSinglePlayer\BoardSinglePlayerPresenter.cs", "C#", -78, 0, -14, -92
"c:\Users\danie\Desktop\symfonia-mistrzow-game\Assets\Scripts\UI\Board\BoardPlayersPanel\BoardSinglePlayer\BoardSinglePlayerView.cs", "C#", -13, 0, -2, -15
"c:\Users\danie\Desktop\symfonia-mistrzow-game\Assets\Scripts\UI\Board\BoardPlayersPanel\BoardSinglePlayer\BoardSinglePlayerViewModel.cs", "C#", -36, 0, -7, -43
"c:\Users\danie\Desktop\symfonia-mistrzow-game\Assets\Scripts\UI\Board\BoardPresenter.cs", "C#", 2, 0, 0, 2
"c:\Users\danie\Desktop\symfonia-mistrzow-game\Assets\Scripts\UI\CardPurchaseWindow\CardPurchaseSingleToken\CardPurchaseSingleTokenPresenter.cs", "C#", 24, 0, 3, 27
"c:\Users\danie\Desktop\symfonia-mistrzow-game\Assets\Scripts\UI\CardPurchaseWindow\CardPurchaseSingleToken\CardPurchaseSingleTokenView.cs", "C#", 7, 0, 1, 8
"c:\Users\danie\Desktop\symfonia-mistrzow-game\Assets\Scripts\UI\CardPurchaseWindow\CardPurchaseSingleToken\CardPurchaseSingleTokenViewModel.cs", "C#", 4, 0, 1, 5
"c:\Users\danie\Desktop\symfonia-mistrzow-game\Assets\Scripts\UI\CardPurchaseWindow\CardPurchaseSingleToken\CardPurchaseTokenElement.cs", "C#", 14, 0, 2, 16
"c:\Users\danie\Desktop\symfonia-mistrzow-game\Assets\Scripts\UI\CardPurchaseWindow\CardPurchaseWindowPresenter.cs", "C#", -2, 0, 0, -2
"c:\Users\danie\Desktop\symfonia-mistrzow-game\Assets\Scripts\UI\Elements\ValueChangeAnimationController.cs", "C#", 8, 0, 2, 10
"c:\Users\danie\Desktop\symfonia-mistrzow-game\Assets\Scripts\UI\MusicCardDetailsPanel\MusicCardDetailsPanelPresenter.cs", "C#", -1, 0, 0, -1
"c:\Users\danie\Desktop\symfonia-mistrzow-game\Assets\Scripts\UI\MusicCardDetailsPanel\MusicCardDetailsPanelView.cs", "C#", -44, -16, -6, -66
"Total", "-", -29, -16, 1, -44