"filename", "language", "C#", "comment", "blank", "total"
"c:\Users\danie\Desktop\symfonia-mistrzow-game\Assets\Scripts\Commands\Command.cs", "C#", 5, 0, 2, 7
"c:\Users\danie\Desktop\symfonia-mistrzow-game\Assets\Scripts\Commands\CommandFactory.cs", "C#", 2, 0, 0, 2
"c:\Users\danie\Desktop\symfonia-mistrzow-game\Assets\Scripts\Commands\CommandQueueUsageExample.cs", "C#", -137, 192, -51, 4
"c:\Users\danie\Desktop\symfonia-mistrzow-game\Assets\Scripts\Commands\CommandServiceDebugger.cs", "C#", -141, 169, -27, 1
"c:\Users\danie\Desktop\symfonia-mistrzow-game\Assets\Scripts\Events\GameEvents.cs", "C#", 8, 1, 3, 12
"c:\Users\danie\Desktop\symfonia-mistrzow-game\Assets\Scripts\Managers\GameManager.cs", "C#", 3, 0, 0, 3
"c:\Users\danie\Desktop\symfonia-mistrzow-game\Assets\Scripts\Test\GameTestManager.cs", "C#", 1, 0, 0, 1
"c:\Users\danie\Desktop\symfonia-mistrzow-game\Assets\Scripts\UI\Board\BoardPlayersPanel\BoardPlayersPanelPresenter.cs", "C#", 39, 0, 12, 51
"c:\Users\danie\Desktop\symfonia-mistrzow-game\Assets\Scripts\UI\Board\BoardPlayersPanel\BoardPlayersPanelView.cs", "C#", 7, 0, 2, 9
"c:\Users\danie\Desktop\symfonia-mistrzow-game\Assets\Scripts\UI\Board\BoardPlayersPanel\BoardPlayersPanelViewModel.cs", "C#", 6, 0, 1, 7
"c:\Users\danie\Desktop\symfonia-mistrzow-game\Assets\Scripts\UI\Board\BoardPlayersPanel\BoardSinglePlayer\BoardSinglePlayerPresenter.cs", "C#", 76, 0, 14, 90
"c:\Users\danie\Desktop\symfonia-mistrzow-game\Assets\Scripts\UI\Board\BoardPlayersPanel\BoardSinglePlayer\BoardSinglePlayerView.cs", "C#", 13, 0, 2, 15
"c:\Users\danie\Desktop\symfonia-mistrzow-game\Assets\Scripts\UI\Board\BoardPlayersPanel\BoardSinglePlayer\BoardSinglePlayerViewModel.cs", "C#", 35, 0, 7, 42
"Total", "-", -83, 362, -35, 244