"filename", "language", "C#", "comment", "blank", "total"
"c:\Users\danie\Desktop\symfonia-mistrzow-game\Assets\Scripts\AnimationSequencer\PlayUIEffectTweener.cs", "C#", 43, 0, 5, 48
"c:\Users\danie\Desktop\symfonia-mistrzow-game\Assets\Scripts\AnimationSequencer\SetTargetTransformScale.cs", "C#", 40, 0, 5, 45
"c:\Users\danie\Desktop\symfonia-mistrzow-game\Assets\Scripts\Commands\Command.cs", "C#", 480, 11, 101, 592
"c:\Users\danie\Desktop\symfonia-mistrzow-game\Assets\Scripts\Commands\CommandExecutor.cs", "C#", 201, 57, 37, 295
"c:\Users\danie\Desktop\symfonia-mistrzow-game\Assets\Scripts\Commands\CommandFactory.cs", "C#", 167, 11, 48, 226
"c:\Users\danie\Desktop\symfonia-mistrzow-game\Assets\Scripts\Commands\CommandQueue.cs", "C#", 208, 44, 43, 295
"c:\Users\danie\Desktop\symfonia-mistrzow-game\Assets\Scripts\Commands\CommandQueueUsageExample.cs", "C#", 4, 279, 3, 286
"c:\Users\danie\Desktop\symfonia-mistrzow-game\Assets\Scripts\Commands\CommandService.cs", "C#", 167, 49, 37, 253
"c:\Users\danie\Desktop\symfonia-mistrzow-game\Assets\Scripts\Commands\CommandServiceDebugger.cs", "C#", 2, 189, 1, 192
"c:\Users\danie\Desktop\symfonia-mistrzow-game\Assets\Scripts\Commands\GameUICommand.cs", "C#", 411, 5, 80, 496
"c:\Users\danie\Desktop\symfonia-mistrzow-game\Assets\Scripts\Commands\ICommand.cs", "C#", 58, 39, 15, 112
"c:\Users\danie\Desktop\symfonia-mistrzow-game\Assets\Scripts\Data\ConcertCardData.cs", "C#", 26, 0, 8, 34
"c:\Users\danie\Desktop\symfonia-mistrzow-game\Assets\Scripts\Data\ConcertCardDeckData.cs", "C#", 10, 0, 2, 12
"c:\Users\danie\Desktop\symfonia-mistrzow-game\Assets\Scripts\Data\MusicCardData.cs", "C#", 40, 2, 7, 49
"c:\Users\danie\Desktop\symfonia-mistrzow-game\Assets\Scripts\Data\MusicCardDeckData.cs", "C#", 11, 0, 3, 14
"c:\Users\danie\Desktop\symfonia-mistrzow-game\Assets\Scripts\Data\ResourceCost.cs", "C#", 76, 3, 9, 88
"c:\Users\danie\Desktop\symfonia-mistrzow-game\Assets\Scripts\Data\ResourceType.cs", "C#", 12, 0, 2, 14
"c:\Users\danie\Desktop\symfonia-mistrzow-game\Assets\Scripts\Data\ResourceTypeExtensions.cs", "C#", 73, 4, 8, 85
"c:\Users\danie\Desktop\symfonia-mistrzow-game\Assets\Scripts\Data\ResourceTypeImages.cs", "C#", 10, 0, 2, 12
"c:\Users\danie\Desktop\symfonia-mistrzow-game\Assets\Scripts\Data\SingleResourceTypeImages.cs", "C#", 17, 0, 1, 18
"c:\Users\danie\Desktop\symfonia-mistrzow-game\Assets\Scripts\Events\AsyncEventBus.cs", "C#", 218, 17, 47, 282
"c:\Users\danie\Desktop\symfonia-mistrzow-game\Assets\Scripts\Events\AsyncEventBusUsageExample.cs", "C#", 92, 80, 20, 192
"c:\Users\danie\Desktop\symfonia-mistrzow-game\Assets\Scripts\Events\GameEvents.cs", "C#", 37, 177, 6, 220
"c:\Users\danie\Desktop\symfonia-mistrzow-game\Assets\Scripts\Events\UIEvents.cs", "C#", 399, 10, 69, 478
"c:\Users\danie\Desktop\symfonia-mistrzow-game\Assets\Scripts\Managers\GameManager.cs", "C#", 92, 1, 18, 111
"c:\Users\danie\Desktop\symfonia-mistrzow-game\Assets\Scripts\Models\BoardModel.cs", "C#", 360, 4, 71, 435
"c:\Users\danie\Desktop\symfonia-mistrzow-game\Assets\Scripts\Models\ConcertCardModel.cs", "C#", 36, 0, 6, 42
"c:\Users\danie\Desktop\symfonia-mistrzow-game\Assets\Scripts\Models\GameConfig.cs", "C#", 105, 0, 20, 125
"c:\Users\danie\Desktop\symfonia-mistrzow-game\Assets\Scripts\Models\GameModel.cs", "C#", 311, 16, 75, 402
"c:\Users\danie\Desktop\symfonia-mistrzow-game\Assets\Scripts\Models\GameState.cs", "C#", 16, 1, 5, 22
"c:\Users\danie\Desktop\symfonia-mistrzow-game\Assets\Scripts\Models\MusicCardCollectionModel.cs", "C#", 112, 4, 20, 136
"c:\Users\danie\Desktop\symfonia-mistrzow-game\Assets\Scripts\Models\MusicCardModel.cs", "C#", 26, 1, 3, 30
"c:\Users\danie\Desktop\symfonia-mistrzow-game\Assets\Scripts\Models\MusicCardRepository.cs", "C#", 66, 0, 13, 79
"c:\Users\danie\Desktop\symfonia-mistrzow-game\Assets\Scripts\Models\PlayerModel.cs", "C#", 102, 0, 25, 127
"c:\Users\danie\Desktop\symfonia-mistrzow-game\Assets\Scripts\Models\PlayerRepository.cs", "C#", 0, 0, 1, 1
"c:\Users\danie\Desktop\symfonia-mistrzow-game\Assets\Scripts\Models\ResourceCollectionModel.cs", "C#", 180, 1, 26, 207
"c:\Users\danie\Desktop\symfonia-mistrzow-game\Assets\Scripts\Models\TurnModel.cs", "C#", 147, 2, 23, 172
"c:\Users\danie\Desktop\symfonia-mistrzow-game\Assets\Scripts\ReactiveObject\ExampleReactiveClass.cs", "C#", 75, 23, 9, 107
"c:\Users\danie\Desktop\symfonia-mistrzow-game\Assets\Scripts\ReactiveObject\ReactiveObject.cs", "C#", 17, 6, 4, 27
"c:\Users\danie\Desktop\symfonia-mistrzow-game\Assets\Scripts\ReactiveObject\ReactiveObjectUsageExample.cs", "C#", 83, 12, 16, 111
"c:\Users\danie\Desktop\symfonia-mistrzow-game\Assets\Scripts\Services\BoardService.cs", "C#", 71, 0, 11, 82
"c:\Users\danie\Desktop\symfonia-mistrzow-game\Assets\Scripts\Services\ConcertCardService.cs", "C#", 20, 0, 3, 23
"c:\Users\danie\Desktop\symfonia-mistrzow-game\Assets\Scripts\Services\ConfigService.cs", "C#", 77, 0, 11, 88
"c:\Users\danie\Desktop\symfonia-mistrzow-game\Assets\Scripts\Services\GameService.cs", "C#", 20, 0, 3, 23
"c:\Users\danie\Desktop\symfonia-mistrzow-game\Assets\Scripts\Services\PlayerService.cs", "C#", 36, 0, 5, 41
"c:\Users\danie\Desktop\symfonia-mistrzow-game\Assets\Scripts\Services\TurnService.cs", "C#", 298, 10, 78, 386
"c:\Users\danie\Desktop\symfonia-mistrzow-game\Assets\Scripts\Test\GameTestManager.cs", "C#", 12, 31, 1, 44
"c:\Users\danie\Desktop\symfonia-mistrzow-game\Assets\Scripts\UI\Board\BoardCardDeck\BoardCardDeckAnimationController.cs", "C#", 23, 0, 3, 26
"c:\Users\danie\Desktop\symfonia-mistrzow-game\Assets\Scripts\UI\Board\BoardCardDeck\BoardCardDeckPresenter.cs", "C#", 46, 0, 12, 58
"c:\Users\danie\Desktop\symfonia-mistrzow-game\Assets\Scripts\UI\Board\BoardCardDeck\BoardCardDeckView.cs", "C#", 40, 0, 5, 45
"c:\Users\danie\Desktop\symfonia-mistrzow-game\Assets\Scripts\UI\Board\BoardCardDeck\BoardCardDeckViewModel.cs", "C#", 11, 0, 1, 12
"c:\Users\danie\Desktop\symfonia-mistrzow-game\Assets\Scripts\UI\Board\BoardEndTurnButton\BoardEndTurnButtonPresenter.cs", "C#", 65, 0, 15, 80
"c:\Users\danie\Desktop\symfonia-mistrzow-game\Assets\Scripts\UI\Board\BoardEndTurnButton\BoardEndTurnButtonView.cs", "C#", 15, 0, 3, 18
"c:\Users\danie\Desktop\symfonia-mistrzow-game\Assets\Scripts\UI\Board\BoardEndTurnButton\BoardEndTurnButtonViewModel.cs", "C#", 28, 0, 7, 35
"c:\Users\danie\Desktop\symfonia-mistrzow-game\Assets\Scripts\UI\Board\BoardMusicCard\BoardMusicCardAnimationController.cs", "C#", 59, 10, 17, 86
"c:\Users\danie\Desktop\symfonia-mistrzow-game\Assets\Scripts\UI\Board\BoardMusicCard\BoardMusicCardPresenter.cs", "C#", 134, 1, 18, 153
"c:\Users\danie\Desktop\symfonia-mistrzow-game\Assets\Scripts\UI\Board\BoardMusicCard\BoardMusicCardView.cs", "C#", 51, 0, 16, 67
"c:\Users\danie\Desktop\symfonia-mistrzow-game\Assets\Scripts\UI\Board\BoardMusicCard\BoardMusicCardViewModel.cs", "C#", 23, 0, 3, 26
"c:\Users\danie\Desktop\symfonia-mistrzow-game\Assets\Scripts\UI\Board\BoardMusicCard\MusicCardCostView.cs", "C#", 21, 0, 2, 23
"c:\Users\danie\Desktop\symfonia-mistrzow-game\Assets\Scripts\UI\Board\BoardMusicCard\MusicCardSingleCostView.cs", "C#", 19, 0, 1, 20
"c:\Users\danie\Desktop\symfonia-mistrzow-game\Assets\Scripts\UI\Board\BoardPlayerPanel\BoardPlayersPanelPresenter.cs", "C#", 110, 0, 18, 128
"c:\Users\danie\Desktop\symfonia-mistrzow-game\Assets\Scripts\UI\Board\BoardPlayerPanel\BoardPlayersPanelView.cs", "C#", 56, 0, 15, 71
"c:\Users\danie\Desktop\symfonia-mistrzow-game\Assets\Scripts\UI\Board\BoardPlayerPanel\BoardPlayersPanelViewModel.cs", "C#", 32, 0, 5, 37
"c:\Users\danie\Desktop\symfonia-mistrzow-game\Assets\Scripts\UI\Board\BoardPresenter.cs", "C#", 110, 1, 21, 132
"c:\Users\danie\Desktop\symfonia-mistrzow-game\Assets\Scripts\UI\Board\BoardToken\BoardTokenChangeValueAnimation.cs", "C#", 7, 0, 2, 9
"c:\Users\danie\Desktop\symfonia-mistrzow-game\Assets\Scripts\UI\Board\BoardToken\BoardTokenEntryAnimation.cs", "C#", 71, 10, 20, 101
"c:\Users\danie\Desktop\symfonia-mistrzow-game\Assets\Scripts\UI\Board\BoardToken\BoardTokenPresenter.cs", "C#", 118, 2, 28, 148
"c:\Users\danie\Desktop\symfonia-mistrzow-game\Assets\Scripts\UI\Board\BoardToken\BoardTokenViewModel.cs", "C#", 20, 0, 3, 23
"c:\Users\danie\Desktop\symfonia-mistrzow-game\Assets\Scripts\UI\Board\BoardView.cs", "C#", 51, 0, 9, 60
"c:\Users\danie\Desktop\symfonia-mistrzow-game\Assets\Scripts\UI\Board\BoardViewModel.cs", "C#", 6, 0, 1, 7
"c:\Users\danie\Desktop\symfonia-mistrzow-game\Assets\Scripts\UI\CardPurchaseWindow\CardPurchaseSingleToken\CardPurchaseSingleTokenPresenter.cs", "C#", 96, 0, 14, 110
"c:\Users\danie\Desktop\symfonia-mistrzow-game\Assets\Scripts\UI\CardPurchaseWindow\CardPurchaseSingleToken\CardPurchaseSingleTokenView.cs", "C#", 32, 0, 5, 37
"c:\Users\danie\Desktop\symfonia-mistrzow-game\Assets\Scripts\UI\CardPurchaseWindow\CardPurchaseSingleToken\CardPurchaseSingleTokenViewModel.cs", "C#", 18, 0, 3, 21
"c:\Users\danie\Desktop\symfonia-mistrzow-game\Assets\Scripts\UI\CardPurchaseWindow\CardPurchaseSingleToken\CardPurchaseTokenElement.cs", "C#", 14, 0, 2, 16
"c:\Users\danie\Desktop\symfonia-mistrzow-game\Assets\Scripts\UI\CardPurchaseWindow\CardPurchaseWindowOpenFromReservedAnimation.cs", "C#", 22, 0, 3, 25
"c:\Users\danie\Desktop\symfonia-mistrzow-game\Assets\Scripts\UI\CardPurchaseWindow\CardPurchaseWindowPresenter.cs", "C#", 123, 0, 21, 144
"c:\Users\danie\Desktop\symfonia-mistrzow-game\Assets\Scripts\UI\CardPurchaseWindow\CardPurchaseWindowPurchaseAnimation.cs", "C#", 19, 0, 4, 23
"c:\Users\danie\Desktop\symfonia-mistrzow-game\Assets\Scripts\UI\CardPurchaseWindow\CardPurchaseWindowView.cs", "C#", 70, 0, 14, 84
"c:\Users\danie\Desktop\symfonia-mistrzow-game\Assets\Scripts\UI\CardPurchaseWindow\CardPurchaseWindowViewModel.cs", "C#", 27, 0, 5, 32
"c:\Users\danie\Desktop\symfonia-mistrzow-game\Assets\Scripts\UI\ConcertCardsWindow\ConcertCardsWindowPresenter.cs", "C#", 58, 0, 13, 71
"c:\Users\danie\Desktop\symfonia-mistrzow-game\Assets\Scripts\UI\ConcertCardsWindow\ConcertCardsWindowView.cs", "C#", 52, 0, 11, 63
"c:\Users\danie\Desktop\symfonia-mistrzow-game\Assets\Scripts\UI\CreateGameWindow\CreateGameWindowPresenter.cs", "C#", 94, 0, 18, 112
"c:\Users\danie\Desktop\symfonia-mistrzow-game\Assets\Scripts\UI\CreateGameWindow\CreateGameWindowView.cs", "C#", 54, 0, 13, 67
"c:\Users\danie\Desktop\symfonia-mistrzow-game\Assets\Scripts\UI\CreateGameWindow\SinglePlayerElement.cs", "C#", 18, 0, 3, 21
"c:\Users\danie\Desktop\symfonia-mistrzow-game\Assets\Scripts\UI\CreatePlayerWindow\CreatePlayerWindowPresenter.cs", "C#", 74, 0, 16, 90
"c:\Users\danie\Desktop\symfonia-mistrzow-game\Assets\Scripts\UI\CreatePlayerWindow\CreatePlayerWindowView.cs", "C#", 42, 0, 14, 56
"c:\Users\danie\Desktop\symfonia-mistrzow-game\Assets\Scripts\UI\CreatePlayerWindow\PlayerImageElement.cs", "C#", 19, 0, 3, 22
"c:\Users\danie\Desktop\symfonia-mistrzow-game\Assets\Scripts\UI\Elements\ButtonElement.cs", "C#", 56, 7, 19, 82
"c:\Users\danie\Desktop\symfonia-mistrzow-game\Assets\Scripts\UI\Elements\CardRequirementContainer.cs", "C#", 19, 0, 2, 21
"c:\Users\danie\Desktop\symfonia-mistrzow-game\Assets\Scripts\UI\Elements\ConcertCardElement.cs", "C#", 60, 0, 10, 70
"c:\Users\danie\Desktop\symfonia-mistrzow-game\Assets\Scripts\UI\Elements\UniversalPlayerResourceElement.cs", "C#", 31, 0, 6, 37
"c:\Users\danie\Desktop\symfonia-mistrzow-game\Assets\Scripts\UI\Elements\UniversalTokenElement.cs", "C#", 41, 0, 10, 51
"c:\Users\danie\Desktop\symfonia-mistrzow-game\Assets\Scripts\UI\Elements\ValueChangeAnimationController.cs", "C#", 47, 0, 8, 55
"c:\Users\danie\Desktop\symfonia-mistrzow-game\Assets\Scripts\UI\GameWindow\GameWindowPresenter.cs", "C#", 69, 0, 10, 79
"c:\Users\danie\Desktop\symfonia-mistrzow-game\Assets\Scripts\UI\GameWindow\GameWindowView.cs", "C#", 32, 0, 1, 33
"c:\Users\danie\Desktop\symfonia-mistrzow-game\Assets\Scripts\UI\GameWindow\GameWindowViewModel.cs", "C#", 6, 0, 1, 7
"c:\Users\danie\Desktop\symfonia-mistrzow-game\Assets\Scripts\UI\InfoWindow\InfoWindowPresenter.cs", "C#", 57, 0, 12, 69
"c:\Users\danie\Desktop\symfonia-mistrzow-game\Assets\Scripts\UI\InfoWindow\InfoWindowView.cs", "C#", 37, 0, 9, 46
"c:\Users\danie\Desktop\symfonia-mistrzow-game\Assets\Scripts\UI\MenuWindow\MenuWindowPresenter.cs", "C#", 44, 0, 9, 53
"c:\Users\danie\Desktop\symfonia-mistrzow-game\Assets\Scripts\UI\MenuWindow\MenuWindowView.cs", "C#", 16, 0, 2, 18
"c:\Users\danie\Desktop\symfonia-mistrzow-game\Assets\Scripts\UI\MusicCardDetailsPanel\DetailsMusicCardView.cs", "C#", 52, 0, 8, 60
"c:\Users\danie\Desktop\symfonia-mistrzow-game\Assets\Scripts\UI\MusicCardDetailsPanel\MusicCArdDetailsPanelCloseForReservedAnimationController.cs", "C#", 17, 0, 4, 21
"c:\Users\danie\Desktop\symfonia-mistrzow-game\Assets\Scripts\UI\MusicCardDetailsPanel\MusicCardDetailsPanelCloseAnimation.cs", "C#", 160, 34, 43, 237
"c:\Users\danie\Desktop\symfonia-mistrzow-game\Assets\Scripts\UI\MusicCardDetailsPanel\MusicCardDetailsPanelOpenAnimation.cs", "C#", 174, 35, 47, 256
"c:\Users\danie\Desktop\symfonia-mistrzow-game\Assets\Scripts\UI\MusicCardDetailsPanel\MusicCardDetailsPanelOpenFromBoardAnimationController.cs", "C#", 28, 0, 4, 32
"c:\Users\danie\Desktop\symfonia-mistrzow-game\Assets\Scripts\UI\MusicCardDetailsPanel\MusicCardDetailsPanelPresenter.cs", "C#", 81, 0, 14, 95
"c:\Users\danie\Desktop\symfonia-mistrzow-game\Assets\Scripts\UI\MusicCardDetailsPanel\MusicCardDetailsPanelView.cs", "C#", 66, 0, 11, 77
"c:\Users\danie\Desktop\symfonia-mistrzow-game\Assets\Scripts\UI\MusicCardDetailsPanel\MusicCardDetailsPanelViewModel.cs", "C#", 16, 0, 5, 21
"c:\Users\danie\Desktop\symfonia-mistrzow-game\Assets\Scripts\UI\PlayerResourcesWindow\PlayerResourcesWindowPresenter.cs", "C#", 84, 0, 16, 100
"c:\Users\danie\Desktop\symfonia-mistrzow-game\Assets\Scripts\UI\PlayerResourcesWindow\PlayerResourcesWindowView.cs", "C#", 84, 0, 16, 100
"c:\Users\danie\Desktop\symfonia-mistrzow-game\Assets\Scripts\UI\PlayerResourcesWindow\PlayerResourcesWindowViewModel.cs", "C#", 0, 0, 1, 1
"c:\Users\danie\Desktop\symfonia-mistrzow-game\Assets\Scripts\UI\ReturnTokenWindow\ReturnTokenAllTokenCountElement.cs", "C#", 23, 0, 2, 25
"c:\Users\danie\Desktop\symfonia-mistrzow-game\Assets\Scripts\UI\ReturnTokenWindow\ReturnTokenSelectedPanel\ReturnTokenSelectedPanelPresenter.cs", "C#", 122, 0, 17, 139
"c:\Users\danie\Desktop\symfonia-mistrzow-game\Assets\Scripts\UI\ReturnTokenWindow\ReturnTokenSelectedPanel\ReturnTokenSelectedPanelView.cs", "C#", 69, 0, 12, 81
"c:\Users\danie\Desktop\symfonia-mistrzow-game\Assets\Scripts\UI\ReturnTokenWindow\ReturnTokenSelectedPanel\ReturnTokenSelectedPanelViewModel.cs", "C#", 90, 0, 17, 107
"c:\Users\danie\Desktop\symfonia-mistrzow-game\Assets\Scripts\UI\ReturnTokenWindow\ReturnTokenSinglePlayerToken\ReturnTokenSinglePlayerTokenPresenter.cs", "C#", 101, 0, 17, 118
"c:\Users\danie\Desktop\symfonia-mistrzow-game\Assets\Scripts\UI\ReturnTokenWindow\ReturnTokenSinglePlayerToken\ReturnTokenSinglePlayerTokenView.cs", "C#", 25, 0, 4, 29
"c:\Users\danie\Desktop\symfonia-mistrzow-game\Assets\Scripts\UI\ReturnTokenWindow\ReturnTokenSinglePlayerToken\ReturnTokenSinglePlayerTokenViewModel.cs", "C#", 52, 0, 10, 62
"c:\Users\danie\Desktop\symfonia-mistrzow-game\Assets\Scripts\UI\ReturnTokenWindow\ReturnTokenWindowPresenter.cs", "C#", 123, 0, 17, 140
"c:\Users\danie\Desktop\symfonia-mistrzow-game\Assets\Scripts\UI\ReturnTokenWindow\ReturnTokenWindowView.cs", "C#", 41, 0, 4, 45
"c:\Users\danie\Desktop\symfonia-mistrzow-game\Assets\Scripts\UI\ReturnTokenWindow\ReturnTokenWindowViewModel.cs", "C#", 40, 0, 7, 47
"c:\Users\danie\Desktop\symfonia-mistrzow-game\Assets\Scripts\UI\SelectTokenWindow\ChoosenBoardTokenPanel\ChoosenBoardTokenPanelPresenter.cs", "C#", 124, 0, 18, 142
"c:\Users\danie\Desktop\symfonia-mistrzow-game\Assets\Scripts\UI\SelectTokenWindow\ChoosenBoardTokenPanel\ChoosenBoardTokenPanelView.cs", "C#", 68, 0, 12, 80
"c:\Users\danie\Desktop\symfonia-mistrzow-game\Assets\Scripts\UI\SelectTokenWindow\ChoosenBoardTokenPanel\ChoosenBoardTokenPanelViewModel.cs", "C#", 91, 0, 17, 108
"c:\Users\danie\Desktop\symfonia-mistrzow-game\Assets\Scripts\UI\SelectTokenWindow\ChoosenBoardTokenPanel\ChoosenSingleBoardTokenView.cs", "C#", 21, 0, 4, 25
"c:\Users\danie\Desktop\symfonia-mistrzow-game\Assets\Scripts\UI\SelectTokenWindow\SelectBoardTokenPanel\SelectBoardTokenPanelPresenter.cs", "C#", 81, 0, 18, 99
"c:\Users\danie\Desktop\symfonia-mistrzow-game\Assets\Scripts\UI\SelectTokenWindow\SelectBoardTokenPanel\SelectBoardTokenPanelView.cs", "C#", 10, 0, 1, 11
"c:\Users\danie\Desktop\symfonia-mistrzow-game\Assets\Scripts\UI\SelectTokenWindow\SelectBoardTokenPanel\SelectBoardTokenPanelViewModel.cs", "C#", 26, 0, 5, 31
"c:\Users\danie\Desktop\symfonia-mistrzow-game\Assets\Scripts\UI\SelectTokenWindow\SelectBoardTokenPanel\SelectSingleToken\SelectSingleTokenPresenter.cs", "C#", 120, 1, 17, 138
"c:\Users\danie\Desktop\symfonia-mistrzow-game\Assets\Scripts\UI\SelectTokenWindow\SelectBoardTokenPanel\SelectSingleToken\SelectSingleTokenView.cs", "C#", 56, 6, 11, 73
"c:\Users\danie\Desktop\symfonia-mistrzow-game\Assets\Scripts\UI\SelectTokenWindow\SelectBoardTokenPanel\SelectSingleToken\SelectSingleTokenViewModel.cs", "C#", 67, 0, 12, 79
"c:\Users\danie\Desktop\symfonia-mistrzow-game\Assets\Scripts\UI\SelectTokenWindow\SelectTokenWindowPresenter.cs", "C#", 109, 1, 20, 130
"c:\Users\danie\Desktop\symfonia-mistrzow-game\Assets\Scripts\UI\SelectTokenWindow\SelectTokenWindowView.cs", "C#", 45, 0, 7, 52
"c:\Users\danie\Desktop\symfonia-mistrzow-game\Assets\Scripts\UI\SelectTokenWindow\SelectTokenWindowViewModel.cs", "C#", 55, 0, 11, 66
"c:\Users\danie\Desktop\symfonia-mistrzow-game\Assets\Scripts\UI\StartPageWindow\StartPagePresenter.cs", "C#", 81, 0, 18, 99
"c:\Users\danie\Desktop\symfonia-mistrzow-game\Assets\Scripts\UI\StartPageWindow\StartPageView.cs", "C#", 38, 0, 9, 47
"c:\Users\danie\Desktop\symfonia-mistrzow-game\Assets\Scripts\UI\StartTurnWindow\StartTurnWindowPresenter.cs", "C#", 58, 0, 10, 68
"c:\Users\danie\Desktop\symfonia-mistrzow-game\Assets\Scripts\UI\StartTurnWindow\StartTurnWindowView.cs", "C#", 38, 0, 7, 45
"Total", "-", 10063, 1197, 1965, 13225